1111111111111111111
10000000000E0000C01
1010010100110100101
1010010010100100101
1P0000000C00C000001
1111111111111111111