111111
1P0C01
100001
1CXE01
111111
